##################################################
##################################################
##################################################
##################################################
##################################################
##################BB##############################
#################BBBBB############################
###############BBBBBBMBMMMB##########M############
##############BBBBBBBBBBBMBB####MMM##MM###########
##############BBBBBTBBBBBMMBB##MMMMM##############
#############BBFFBBBBBMBBBBBM#MMMMMMM##M##########
##########BBBBBFFBBBBBBBBMBMMMMMMMMMMMMMMM########
#########BBBFFFFFFBBBFFBMBBMMMMMMMMCMMMMMM########
########BBFFFFFFFFFFFFFFBBMMBMBMMMMBBMMMMMM#######
########BFFFFFFWFWFFWFFFBBBBBBBBMMBBBBMMMMM#M#####
#######BFFFFWFFFFFFWFWFFWFFFBMBBBBBBBMMMMMM##M####
######BBFFFWFFWFWFWWWFFWWWFFBBMBBBBBMMMMBMMM######
#####BBFFFWWWWWWWWWWWWWFWFFFFBBB##BBMBBBBMMMM#####
#####BBFFFFWWWWWWWWWWWFWFFFFFFB####BBB##BBMM######
######BFFFWWWWWWWWWWWWWWFFFFFFF#####B####BBM######
######BFFFWWWWWTWWWWFFWWWWFRRT###########BBB#M####
#####BBFFWWWWCWWWWFFFFFFWFFRFI###############MM###
####BBBFWWWWWWWWWFRRRRFFFFRRII################B###
####BBFFWWWWWWWWFRRIIRRRFFRIIFF###################
###BBFFFFWWWWWWWFRIIIIIRRRRIFFF###################
###BBFFFWWWWWWWFFRIIFFIIFFFIFFFB##################
###BFFFWWWFWWWWFFRFIIFFIFFFIFFFFB##BBBB###########
###BFFFFWFFFWFWWFRFFIFFIIFIIFWFFFBBFFFBB##########
###BBBFFFFFWFFFFFRFFIIFFIIIFFFFWFFFFFFFBB#########
####BBBBBFFFFFIIFRFFIIFFFFFFWFWWWFFFFWFFB#########
####BB###IIFFIIIIRFFFIFFFWFFWFFFWFMFFMWFB#########
#########IIIIIFFITFFFIFFWFWWFWMWFWFMMFFFFB########
#########FFIIIFFIFFFIIFFWWWFFMMMMFMMMMMFFFBBB#####
######BFFFFFFFFFIIFFIFFWWWFWMMMMMMMMMMMMMFFFBB####
######BFFFFFWFFFFIIIIFFFFMFFMMMMMMMBBMMMMMMFFB####
#####BBFFWFWFFFFFFIIIIFFIIMMMMMIMMMBBBMBMMMFFB####
#####BFFFFWWFMFFFFFFFIIIIIMMMIIIMMBMBBBBBBMMFB####
####BBFFWFWFFFMMMFFFFFIIIIIMIIFMMMBBBMBMBBMMFBB###
####BBFFFCWWFFFFMMFFMIIIIIMMIFFMMBBMBMBBBBBMMBB###
#####BFFFWWFWFFFMMMMMIIIIIIIIFMWBBBBMB##BBBBMMBB##
#####BFFFFFFFFMFFMMMMMMMFIIIFFWWBBB########BBMBB##
#####BBBBBBFFFFMMMMMMMMFFFIIFWWBBB##B#######BBBM##
##########BFMFMM###MMCBBFFFIFFFBBB#BMB########BCM#
###########BBMM#####MBBBBFFIIFBBB##BMMB#########M#
####################BBBBBBF##BBB##BBMMBB##########
######################BBB##########MMMM###########
###################################M##############
##################################################
##################################################
##################################################