#######
#WWWWW#
#WWGGW#
#WGGGW#
#WGGWW#
#WWWWW#
#######